-6 -6 -6 -6 -6 -6 -6 -6 -6 -6 -6 -6 -6 -6 -6 -6 -6 -6 -6 -6 -6 -6 -6 -6 -6 -6 -6 -6 -6 -6 -6 -6 -6 -6 -6 -6 -6 -6 -6 -6 -6 -6 -6 -6 -6 -6 -6 -6 -6 -6 -6 -6 -6 -6 -6 -6 -6 -6 -6 -6 -6 -6 -6 -6 -6 -6 -6 -6 -6 -6 -6 -6 -6 -6 -6 -6 -6 -6 -6 -1 -1 -1 -1 -1 -1 -1 -1 -1 -1 -1 -1 -1 -1 -1 -1 -1 -1 -1 -1 -1 -1 -1 -1 -1 -1 -1 -1 -1 -1 -1 -1 -1 -1 -1 -1 -1  3 -8 -8 -8 -8 -8
-6  7  7 -9  7  7 -5  7  7  1  1  1  1  1  1 -6  1  1 -1  1  1 -6  1  1  1  1  1  1  1  1  1  1  1  1  1  1  1  1  1  1  1  1  1  1  1  1  1  1  1  1  1  1  1  1  1  1  1  1  1  1  1  1  1  1  1  0  0  0  0  0  0  0  0  0  1  1  1  1  1  1  3  3  3  3  3  3  3  3  3  3  3  3  3  3  3  3  3  3  3  3  3  3  3  3  3  3  3  3  3  3 -1  3  3  3  3  3 -1  3 -8 -8 -8 -8
-6  7  7  7  7  7  7  7  7  1  1  1  1  1  1  1 -6  1  1  1 -6  1  1  1  1  1 -6  1  1  1 -6  1  1  1 -6  1  1  1 -6  1  1  1  1  1  1  1  1  1  1  1  1  1  1  1  1  1  1  1  1  1  1  1  1  1  1  0  0  0  0  0  0  0  0  0  1  1  1  1  1  1  1  3  3  3  3  3  3  3  3  3  3 -1  3  3  3  3  3  3  3  3  3  3  3  3  3  3  3  3  3  3 -1  3  3  3  3  3  3 -1  3 -8 -8 -8
-6  7  7  7  7  7  7  7  7  1  1  1  1  1  1  1  1 -6  1 -6  1  1  1  1  1  1  1  1 -6  1  1  1 -6  1  1  1 -6  1  1  1  1  1  1  1  1  1  1  1  1  1 -1 -1  1 -6  1 -1 -1  1  1  1  1  1  1  1  1  5  0  0  0  0  0  0  0  5  1  1  1  1  1  1  1  1  3  3  3  3  3  3  3  3  3  3  3  3  3  3  3  3  3  3  3  3  3  3  3  3  3  3  3  3  3 -1  3  3  3  3  3  3 -1  3 -8 -8
-6  1  1  1  1  1  1  1  1  1  1  1  1  1  1  1  1  1  1  1  1  1  1  1  1  1 -6  1  1  1 -6  1  1  1 -6  1  1  1 -6  1  1  1  1  1  1  1  1  1  1  1  1  1  1  1  1  1  1  1  1  1  1  1  1  1  1  5  5  5  5  5  5  5  5  5  1  1  1  1  1  1  1  1  1  3  3  3  3  3  3  3  3  3  3  3  3  3  3  3  3  3 -1 -1 -1 -1 -1 -1 -1  3  3  3  3  3  3  3  3  3  3  3  3 -1  3 -8
-6  1  1  1  1  1  1  1  1  1  1  1  1  1  1  1  1  1  1  1  1  1  1  1  1  1  1  1 -6  1  1  1 -6  1  1  1 -6  1  1  1  1  1  1  1  1  1  1  1  0  1  1  1  1 -1  1  1  1  1  1  1  1  1  1  1  1  5  0  0  0  0  0  0  0  5  1  1  1  1  1  1  1  1  1  1  3  3  3  3  3  3  3  3  3  3  3  3  3  3  3  3  3  3  3  3  3  3  3  3  3  3  3  3  3  3  3  3  3  3  3  3 -1  3
-6  1  1  1  1  1  1  1  1  1  1  1  1  1  1  1  1  1  1  1  1  1 -6  1  1  1 -6  1  1  1 -6  1  1  1 -6  1  1  1 -6  1  1  1  1  1  1  0  0  0  0  0  1  1  1 -1  1  1  1  1  1  1  1  1  1  1  1  0  0  0 -2 -2 -2  0  0  0  1  1  1  1  1  1  1  1  1  1  1  3  3  3  3  3  3  3  3  3  3  3  3  3  3  3  3  3  3  3  3  3  3  3  3  3  3  3  3  3  3  3  3  3  3  3  3 -1
-6  1  1  1 -6  1  1  1  1 -6  1  1  1  1  1 -6  1  1  1  1  1  1  1  1  1  1  1  1  1  1  1  1  1  1  1  1  1  1  1  1  1  1  1  1  0  0  0  0  0  0  1  1  1  1  1  1  1  1  1  1  1  1  1  1  1  0  0  0 -2 -2 -2  0  0  0  1  1  1  1  1  1  1  1  1  1  1  1  3  3  3  3 -1  3  3  3  3  3  3  3  3  3  3  3  3  3  3  3  3  3  3  3  3  3  3  3  3  3  3  3  3  3  3 -1
-6  1  1  1  1  1  1  1  1  1  1  1  1  1  1  1  1  1  1  1  1  1  1  1  1  1  1  1  1  1  1  1  1  1  1  1  1  1  1  1  1  1  1  1  0  0  0  0  0  0  0  1  1 -6 -6 -6 -6 -6  1 -6 -6 -6 -6 -6  1  0  0  0  0  0  0  0  0  0  1 -8 -12 -12 -12 -12 -12 -12 -12 -12 -8 1 1 3 3 3 3 3 3  3  3  3  3  3  3  3  3  3  3  3  3  3  3  3  3  3  3  3  3  3  3  3  3  3  3  3  3 -1
-6  1 -6  1  1  1  1  1 -6  1  1  1 -1  1  1 -1 -1  1  1  1  1 -1 -1  1 -1  1  1  1  1  1  1  1  1  1  1  1  1  1  1  1 -6 -6 -6 -6 -6 -6 -6 -6 -6 -6 -6 -6 -6 -6 -6 -6 -6 -6  1 -6 -6 -6 -6 -6 -6 -6 -6 -6 -6 -6 -6 -6 -6 -6  1 -8  6  6 6 -13 -14 6  6  6 -8  1  1  1  3  3  3  3  3  3  3  3  3  3  3  3  3  3  3  3  3  3  3 -1  3  3  3  3  3  3  3  3  3  3  3  3  3 -1
-6  1 -6  1  1  1  1  1 -6 -6  1  1 -1 -1  1  1  1 -1 -1 -1  1  1  1  1 -1  1  1  1  1  1  1  6  6 -6  6  6  1  1  1  1 -6 -6  1 -6  1  1  1  1 -6 -6  1  1 -6 -6  1  1  1 -6  1  1  1 -6 -6 -6  1  1  1  1  1 -6 -6 -6 -6 -6  1 -8  6  6 6 -15 -16 6  6  6 -8  1  1  1  1  3  3  3  3  3  3  3  3  3  3  3  3  3  3  3  3  3  3  3  3  3  3 -1  3  3  3 -4  5 -4 -4 -4 -4 -1
-6  1 -6 -6  1  1  1 -6  1 -6  1  1 -1 -1 -1  1  1  1  1  1  1 -1 -1 -1 -1  1  1  1  1  1  1  6  6  6  6  6  1  1  1  1 -6  1  1  1 -6 -6 -6  1  1  1  1 -6 -6  1  1  1 -6  1  1  1 -6 -6  1  1  1  1 -6 -6  1  1 -6 -6 -6 -6  1 -8  6  6  6  6  6  6  6  6 -8  1  1  1  1  1  3  3  3  3  3  3  3  3 -1  3  3  3  3  3  3  3  3  3  3  3 -1 -1  3  3  3 -4  5  5 -10 5 -4 -1
-6  1 -6  1  1 -6  1 -6  1  1  1 -6 -1 -6  1  1 -1 -1 -1  1 -1 -1 -1  1 -1  1  1  1  1  1  1 -6  6 -5  6 -6  1  1  1  1 -6 -6 -6  1  1  1 -6  1  1 -6  1 -6  1  1 -6 -6 -6  1  1 -6 -6  1  1  1 -6  1  1  1 -6  1  1  1  1 -6  1 -8  6  6  6  6  6  6  6  6 -8  1  1  1  1  1  1  3  3  3  3  3  3  3  3  3  3  3  3  3 -1  3  3  3  3  3  3  3  3  3  3 -4  5  5  5  5 -4 -1
-6  1 -6  1  1  1  1 -6  1 -6  1  1 -1  1  1 -1  1  1  1  1  1  1  1  1 -1  1  1  1  1  1  1  6  6  6  6  6  1  1  1  1 -6  1  1  1 -6  1  1  1 -6 -6  1  1  1  1  1  1 -6 -6  1  1  1 -6 -6  1  1  1 -6  1  1 -6 -6  1 -6 -6  1 -12 -12 -12 -12 6  6 -12 -12 -12 -12 1 1 1 1 1 1 1  3  3  3  3  3  3  3  3  3  3  3  3 -1  3  3  3  3  3  3  3  3  3  3 -4  5  5  5  5 -4 -1
-6 -6 -6  1 -6 -6  1  1 -6  1  1  1 -1  1 -1 -1 -1 -1 -1  1 -1 -1  1  1  1  1  1  1  1  1  1  6  6 -6  6  6  1  1  1  1 -6 -6 -6  1  1 -6  1  1  1 -6 -6 -6 -6  1 -6 -6 -6 -6 -6  1  1 -6  1  1 -6  1  1 -6  1 -6 -6 -6 -6 -6  1  1  1  1 -11 1  1 -11 1  1  1  1  1  1  1  1  1  1  1  3  3  3  3  3  3  3  3  3  3  3  3  3  3  3  3  3  3  3  3  3  3 -4  5  5  5 -5 -4 -1
-6  1  1  1  1 -1 -6  1 -6  1  1  1 -1  1  1  1  1  1  1  1  1 -1  1  1  1  1  1  1  1  1  1  1  1  1  1  1  1  1  1  1 -6 -6  1  1 -6  1  1 -6  1  1 -6  1  1  1 -6 -6  1  1  1  1 -6  1  1  1 -6  1 -6  1  1  1 -6 -6 -6 -6  1  1  1  1  1  1  1  1  1  1  1  1  1  1  1  1  1  1  1  1  3  3  3  3  3  3  3  3  3  3  3  3  3  3  3  3  3  3  3  3  3 -4 -4 -4 -4 -4 -4 -1
-6  1 -6 -6  1  1  1  1 -6  1  1  1 -1  1 -1 -1 -1 -1 -1  1 -1 -1 -1 -1 -1 -1 -1 -1 -1 -1 -1 -1 -1 -1 -1 -1 -1 -1 -1 -1 -6  1 -6  1 -6 -6  1  1  1 -6 -6  1 -6  1  1  1  1 -6 -6 -6 -6  1  1 -6 -6  1  1 -6  1  1  1 -6 -6 -6 -6 -6 -6  1 -6 -6 -6 -6 -6 -6 -6 -6 -6 -6 -6 -6 -6 -6 -6 -6 -6 -1 -1 -1 -1 -1 -1 -1 -1 -1 -1 -1 -1 -1 -1 -1 -1 -1 -1 -1 -1 -1 -1 -1 -1 -1 -1 -1
-6  1 -6  1  1 -1  1 -6 -6 -6  1  1 -1 -1 -1 -1 -6 -1 -1 -1 -1  1  1 -1 -1  1  1  1  1  1  1  1  1  1  1  1  1  1  1  1 -6  1  1  1  1  1  1 -6 -6 -6 -6  1  1 -6 -6 -6 -6 -6 -6 -6 -6 -6 -6 -6  1  1 -6 -6 -6 -6  1  1 -6 -6  1  1  1  1  1  1  1  1  1  1  1  1  1  1  1  1  1  1  1  1  1  1  1  1  1  1  1  1  1  1  1  1  1  1  1  1 -1 -1 -1 -1 -1 -1 -1 -1 -1 -1 -1 -1
-6  1  1  1  1  1  1  1 -6  1  1  1  1  1  1  1  1  1  1  1  1  1  1  1  1  1  1  1  1  1  1  1  1  1  1  1  1  1  1  1 -6  1 -6  1  1 -6 -6 -6  1  1 -6 -6 -6  1  1  1  1 -6 -6  1 -6 -6 -6  1  1 -6 -6 -6 -6 -6 -6  1 -6 -6  1  1  1  1  1  1  1  1  1  1  1 -6 -6  1  1  1 -6  1  1 -6 -6  1  1  1 -6 -6 -6  1  1 -6  1  1 -6 -6  1  1  1  1  1  1  1  1  1  1  1  1  1 -6
-6  1  1  1  1  1  1  1  1  1  1  1  1  1 -4 -4 -4 -4 -4 -4 -4 -4 -4 -4 -6 -6 -6 -6 -6 -6 -6 -6 -6 -6 -6 -6 -6 -6  1  1 -6  1  1  1 -6 -6 -6  1  1  1  1 -6 -6 -6 -6  1  1  1  1  1 -6  1 -6  1  1  1 -6 -6  1  1 -6 -6 -6 -6  1  1  1  1  1  1  1  1  1  1  1 -6  1 -6  1 -6  1 -6  1 -6  1 -6  1  1  1 -6  1  1 -6  1 -6  1 -6  1 -6  1  1  1  2  2  2  2  2  1  1  1  1 -6
-6  1  1 -1 -1 -1 -1  1  1  1  1  1  1  1 -4  5  5 -4  5  5 -10 5  5 -4  1  1  1  1  1  1  1  1  1  1  1  1  1  1  1  1 -6 -6 -6  1 -6 -6  1  1 -6 -6  1  1  1 -6  1  1 -6 -6 -6  1  1  1  1  1 -6  1  1  1  1  1  1  1  1 -6  1  1  1  1  1  1  1  1  1  1  1 -6 -6  1  1 -6  1 -6  1 -6 -6  1  1  1  1 -6  1  1 -6  1 -6  1 -6 -6  1  1  1  1  2  0  2  0  2  1  1  1  1 -6
-6  1  1  1 -1 -1 -1 -1 -1 -1  1  1  1  1  5  5  5 -4  5  5  5  5  5 -4  1  1  1  1  1  1  1  1  1  1  1  1  1 -6 -6 -6 -6 -6 -6  1  1 -6 -6  1 -6  1  1 -6 -6  1  1  1 -6  1  1 -6 -6 -6 -6  1 -6 -6  1  1  1  1 -6 -6  1 -6 -6  1  1  1  1  1  1  1  1  1  1 -6  1 -6  1 -6  1 -6  1 -6  1 -6  1  1  1 -6  1  1 -6  1 -6  1 -6  1  1  1  1  1  2  2  2  2  2  1  1  1 -9 -6
-6  1  1  1  1 -1  1  1 -1 -1 -1 -1 -1  1 -4  5  5  5  5  5  5  5  5 -4  1  1  1  1  1  1  1  1  1  1  1  1  1 -6 -6 -6 -6  1 -6 -6  1  1 -6  1 -6 -6  1  1 -6 -6 -6  1  1 -6  1 -6 -6  1 -6 -6  1  1  1  1  1  1 -6 -6 -6 -6 -6 -6  1  1  1  1  1  1  1  1  1 -6  1 -6  1  1 -6  1  1 -6 -6  1  1  1  1 -6  1  1  1 -6  1  1 -6  1  1  1  1  1  2  0  0  0  2  1  1  1  1 -6
-6  1  1 -6  1  1  1  1  1  1 -1 -1 -1  1 -4  5  5 -4  5  5  5  5  5 -4  1  1  1  1  1  1  1  1  1  1  1  1  1  1  1 -6 -6  1  1  1  1 -6  1  1  1 -6 -6  1 -6  1  1  1 -6 -6  1 -6 -6  1 -6  1  1  1 -6  1 -6 -6 -6 -6 -6 -6 -6 -6 -6  1  1  1  1  1  1  1  1  1  1  1  1  1  1  1  1  1  1  1  1  1  1  1  1  1  1  1  1  1  1  1  1  1  1  1  2  2  2  2  2  1  1  1  1 -6
-6  1  1  1  1  1  1  1  1  1 -1 -1 -1 -6 -4 -4 -4 -4 -4 -4 -4  5 -4 -4 -6 -6 -6 -6 -6 -6 -6 -6 -6 -6 -6 -6 -6 -6  1  1 -6 -6  1 -6  1  1 -6  1 -6 -6 -6  1 -6 -6 -6  1 -6 -6  1 -6 -6  1 -6  1 -6 -6 -6  1  1 -6 -6 -6 -6 -6 -6 -6 -6 -6 -6 -6 -6 -6 -6 -6 -6 -6  1  1  1  1  1  1  1  1  1  1  1  1  1  1  1  1  1  1  1  1  1  1  1  1  1  1  1  1  1  1  1  1  1  1  1 -6
-7  2  2  2  2  2  2  2  2  2  2  2  2  2  2  2  2  1  1  1  1  1  1  1  1  1  1  1  1  1  1  1  1  1  1  1  1  1  1  1 -6 -6 -6 -6  1 -6  1  1 -6  1  1  1 -6  1  1  1  1 -6 -6 -6  1  1 -6  1  1  1 -6  1  1  1 -6 -6 -6 -6 -6 -6 -6 -6 -6 -6 -6 -6 -6 -6 -6 -6  1  1  1  1  1  1  1  1  1  1  1  1  1  1  1  1  1  1  1  1  1  1  1  1  1  1  1  1  1  1  1  1  1  1  1 -6
-7  2  2  2  2  2  2  2  2  2  2  2  2  2  2  2  2  1  1  1  1  1  1  1  1  1  1  1  1  1  1  1  1  1  1  1  1  1  1  1 -6 -6 -6 -6  1  1  1  1 -6  1 -6  1  1 -6  1  1  1  1 -6  1  1  1 -6 -6 -6  1 -6 -6 -6  1  1  1 -6  1  1  1  1  1  1  0  0  0  0  0 -6 -6  1  1  1  1  1  1  1  1  1  1  1  1  1  1  1  1  1  1  1  1  1  1  1  1  1  1  1  1  1  1  1  1  1  1  1 -6
-7  2  2  2  2  2  2  2  2  2  2  2  2  2  2  2  2  1  1  1  1  1  1  1  1  1  1  1  1  1  1  1  1  1  1  1  1  1  1  1  1 -6 -6  1  1 -6 -6  1  1  1  1  1 -6  1  1 -6 -6  1  1 -6 -6  1  1 -6  1  1  1 -6 -6 -6 -6  1 -6  1  1  1  1  1  1  1  0  0  0  0 -6 -6 -6 -6 -6 -6 -6 -6 -6 -6 -6 -6 -6 -6 -6 -6 -6 -6 -6 -6 -6 -6 -6 -6 -6 -6 -6 -6 -6 -6 -6 -6 -6 -6 -6 -6 -6 -6
 0  0  2  2  2  2  2  2  2  2  2  2  2  2  2  2  2  2  1  1  1  1  1  1  1  1  1  1  1  1  1  1 -6 -6  1  1  1  1  1  1  1  1  1  1  1 -6  1 -6 -6  1 -6  1  1 -6 -6  1 -6  1  1  1  1  1 -6 -6  1 -6  1  1 -6 -6 -6 -6 -6  1  1  1  1  1  1  1  1  0  5  5 -6 -6  1  1  1  1  1  1  1  1  1  1  1  1  1  1  1  1  1  1  1  1  1  1  1  1  1  1  1  1  1  1  1  1  1  1  1 -6
 0  0  0  2  2  2  2  2  2  2  2  2  2  2  2  2  2  2  2  1  1  1  1  1  1  1 -6  1  1  1  1  1  1  1  1 -6  1  1  1  1 -6  1  1 -6  1  1  1 -6  1  1  1  1 -6  1  1  1  1  1 -6 -6 -6  1  1 -6 -6  1  1 -6 -6 -6 -6  1  1  1  1  1  1  1  1  1  1  1  5  5 -6 -6  1  1  1  1  1  1  1  1  1  1  1  1  1  1  1  1  1  1  1  1  1  1  1  1  1  1  1  1  1  1  1  1  1  1  1 -6
 0  0  0  0  2  2  2  2  2  2  2  2  2  2  2  2  2  2  2  2  2  1  1  1  1  1  1  1  1 -6  1  1 -6  1  1  1  1  1  1  1 -6  1  1 -6 -6  1 -6 -6  1  1 -6 -6 -6 -6  1 -6  1 -6 -6  1  1  1  1  1 -6  1  1  1 -6 -6 -6  1 -6  1  1  1  1  1  1  1  1  1  5 -9 -6 -6  1  1  1  1  1  1  1  1  1  1  1  1  1 -1 -1 -1 -1 -1 -1 -1 -1 -1 -1 -1 -1 -1 -1 -1 -1 -1 -1 -1 -1 -1 -1 -1
 0  0  0  0 -7  2  2  2  2  2  2  2  2  2  2  2  2  2  2  2  2  2  2  2  1  1  1  1  1  1  1  1  1  1  1  1  1  1  1  1 -6 -6  1  1 -6 -6 -6 -6 -6  1  1 -6 -6  1 -6  1  1 -6  1  1  1 -6 -6  1  1 -6  1 -6  1  1  1  1 -6  1  1  1  1  1  1  1  1  1  5  5 -6 -6  1  1  1  1  1  1  1  1  1  1  1  1 -1 -1  4  4  4  4  4  4  4 -3 -3 -3 -3 -3  4  4  4  4  4  4 -3 -3 -3 -1
 0  0  0  0 -7  2  2  2  2  2  2  2  2  2  2  2  2  2  2  2  2  2  2  2  2  2  2  2  1  1  1  1  1  1  1  1  1  1  1  1  1 -6  1  1  1  1  1 -6 -6 -6  1  1  1  1  1  1 -6 -6  1 -6 -6 -6 -6  1  1 -6  1 -6 -6 -6  1 -6 -6 -6 -6 -6 -6 -6 -6 -6  1 -6 -6 -6 -6 -6  1  1  1  1  1  1  1  1  1  1  1 -1 -1  4  4  4  4  4  4  4  4 -3 -3 -3 -3 -3  4  4  4  4  4  4 -3 -3 -3 -1
-2  0  0  0  0 -7  2  2  2  2  2  2  2  2  2  2  2  2  2  2  2  2  2  2  2  2  2  2  2  2  2  2  2  2  2  2  2  1  1  1  1 -6 -6 -6 -6 -6 -6 -6 -6 -6 -6 -6 -6 -6 -6 -6  1  1  1  1  1 -6 -6 -6 -6 -6  1  1 -6  1  1 -6 -6 -6  1  1  1  1  1  1  1  1  1  1  1  1  1  1  1  1  1  1  1  1  1  1 -1 -1  4  4  4  4  4  4  4  4  4  4 -3 -3 -3  4  4  4  4 -1  4  4  4 -3 -3 -1
-2 -2  0  0  0  0  2  2  2  2  2  2  2  2  2  2  2 -1  2  2  2  2 -1  2  2  2  2  2  2  2  2  2  2  2  2  2  2  2  1  1  1  1  1  1  1 -6  1  1  1  1  1  1 -6 -6 -6  1  1 -6  1 -6  1  1  1 -6 -6 -6 -6  1  1  1 -6 -6 -6 -6  1 -6 -6 -6  1  1 -6  1  1  1 -6 -6  1 -6  1 -6  1  1  1  1  1  4  4  4  4  4  4  4  4  4 -1 -1 -1  4  4  4  4  4 -1  4  4  4  4  4  4  4  4 -1
-2 -2  0  0  0  0  2  2  2  2  2  2  2  2  2  2  2  2  2  2  2  2  2  2  2  2  2 -1  0 -1  2  2  2  2  2  2  2  2  2  1  1  1  1 -6  1  1  1  1  1  1  1  1  1  1 -6 -6 -6 -6 -6 -6 -6 -6 -6 -6 -6 -6 -6 -6 -6 -6 -6 -6 -6 -6  1 -6  1  1  1 -6  1 -6  1 -6  1  1  1 -6  1 -6  1  1  1  1  4  4  4  4  4  4  4  4  4  4 -3 -3 -3  4  4  4  4 -1 -3 -1  4  4  4  4  4  4  4 -1
-2 -2 -2  0  0  0  2  2  2  2  2  2  2 -7 -7  2  2  2  2  2 -1 -7  2  2  2  2  2  0  0  0  2  2  2  2  2  2  2  2  2  2  1  1  1  1  1 -6  1  1  1  1  1  1  1  1  1  1  1  1  1 -6  1  1  1  1  1  1  1  1  1  1  1  1 -1 -1  1 -6 -6 -6  1 -6 -6 -6  1  1 -6  1  1  1 -6  1  1  1  1  4  4  4  4  4  4  4  4  4  4  4 -1 -1 -1  4  4  4  4  4 -1  4  4  4  4  4  4  4  4 -1
-2 -2 -2 -2 -2  0  2  2  2  2  2  2  2  2  2  2  2  2 -7  2  2  2  2  2  2  2  2 -1  0 -1  2  2  2  2  2 -7  2  2  2  2  2  1  1  1  1  1  1  1  1  1  1  1  1  1  1  1 -6 -6  1  1  1  1  1  1  1  1  1  1  1  1  1  1 -1 -1  1 -6  1  1  1 -6  1 -6  1  1  1 -6  1  1 -6  1  1  1  4  4  4  4  4  4  4  4 -3 -3  4  4  4  4  4  4  4  4  4  4  4  4  4  4  4  4 -3  4  4 -1
-2 -2  0  0  0  0  0  2  2  2  2  2  2  2  2 -7  2  2  2  2  2  2  2  2  2  2  2  2  2  2  2  2  2  2  2  2  2  2  2  2  2  2  1  1  1  1  1  1  1  1  1  1  1  1  1  1  1  1 -6 -6  1  1  1  1  1  1  1  1  1  1  1  1 -1 -1  1 -6 -6 -6  1 -6  1 -6  1 -6 -6  1  1  1 -6  1  1  4  4  4  4  4  4  4  4  4  4 -3 -3 -3  4  4  4  4  4  4  4  4  4  4  4 -1  4  4  4  4  4 -1
-2 -2 -2  0  0  0  0  2  2  2  2  2  2  2  2  2 -1  2  2  2  2  2  2  2  2  2  2  2  2  2  2  2  2  2  2  2  2  2  2  2  2  2  2  1  1  1  1  1  1  1 -6  1  1  1  1  1  1  1  1  1 -6 -6  1  1  1  1  1  1  1  1  1  1 -1 -1  1  1  1  1  1  1  1  1  1  1  1  1  1  1  1  1  4  4  4  4  4  4  4  4  4  4  4 -3 -3 -3  4  4  4  4  4  4  4  4  4  4  4  4  4  4  4  7  7 -1
-2 -2 -2 -2 -2  0  0  2  2  2 -7  2  2  2  2  2  2  2  2  2  2  2 -7  2  2  2 -7  2 -7  2  2  2  2  2  2  2  2  2  2  2  2  2  2  2  1  1  1  1  1  1  1  1  1  1  1  1  1  1  1  1  1  1 -6 -6  1  1  1  1  1  1  1  1 -1 -1 -1 -1 -1 -1 -1 -1 -1 -1 -1  4 -1 -1 -1 -1 -1 -1 -1 -1 -1  4 -1 -1 -1 -1  4 -3 -3 -3 -3  4  4  4  4  4 -3 -3 -3 -3 -3  4  4  4  4  4  4  7 -5 -1
-2 -2 -2 -2 -2 -7  0  2  2  2 -7  2  2  2  2  2  2  2  2  2  2  2  2  2  2  2  2  2  2  2  2  2  2  2  2  2  2  2  2  2  2  2  2  2  2  1  1  1  1  1  1  1 -1  1 -1  1  1  1  1  1  1  1  1  1 -6 -6  1  1  1  1  1  1 -1  4 -1  4  4  4  4  4  4 -1  4  4  4 -1  4  4  4  4  4  4  4  4  4  4 -1 -1  4  4 -3 -3 -3  4  4 -1  4  4  4  4  4  4  4  4  4  4  4  4  4  7  7 -1
-2 -2 -2 -2 -2  0  0  0  2  2 -7  2  2  2  2 -7  2 -1  2  2  2 -7  2  2  2  2  2  2  2  2  6  6  6  2  2  2  2  2  2  2  2  2  2  2  2  2  1  1  1  1  1  1  1  1  1  1  1  1  1  1  1  1  1  1  1  1 -6 -6  1  1  1  1 -1  4 -1  4 -1  4  4  4  4 -1 -1 -1 -1 -1  4 -1  4  4  4 -1  4 -1  4  4 -1 -1  4  4 -3 -3 -3  4 -1 -3 -1  4  4  4  4  4  4  4  4  4  4 -1  4  4  4 -1
-2 -2 -2 -2 -2  0  0  0  2  2 -7  2  2  2  2  2  2  2  2 -7  2  2  2  2  2  2  2  2  2 -7  6 -5  6 -7  2  2  2  2  2  2  2  2  2  2  2  2  2  1  1  1  1  1  1  1  1  1 -1 -1 -1 -1 -1 -1 -1 -1 -1  1  1  1 -6 -6  1  1 -1  4 -1  4 -1  4  4  4  4  4  4  4  4 -1  4  4  4  4  4  4  4 -1  4  4 -1 -1  4  4 -3  4 -3  4  4 -1  4  4  4  4 -3 -1  4 -3 -1  4 -1 -3 -1  4  4 -1
-2 -2 -2 -7  0  0  0 -7  2  2  2  2 -1  2  2  2  2  2  2  2  2  2  2  2  2  2  2  2  2 -7  0  0  0 -7  0  0  2  2  2  2  2  2  2  2  2  2  2  2  1  1  1  1  1  1  1  1  1  1  1  1  1  1  1  1  1  1  1  1  1  1 -6 -6 -1  4 -1  4 -1  4  4  4  4 -1 -1 -1  4 -1  4  4  4 -1  4  4  4 -1  4  4 -1 -1  4  4  4  4  4  4  4  4  4  4  4  4 -1  4  4 -3 -3  4  4 -1  4  4  4 -1
-2 -2  0  0  0  0 -5  6  2  2  2  2 -1 -1  2  2  2  2  2  2  2  2  2  2  2  2  2  2  2  0  0  0  0  0  0  0  2  2  2  2  2  2  2  2  2  2  2  2  2  1  1  1  1  1  1  1  1  1  1  1  1  1  1  1  1  1  1  1  1  1  1  1 -1  4 -1  4 -1  4  4  4  4 -1 -1 -1  4 -1  4  4  4  4  4  4  4 -1  4  4 -1 -1  4  4  4  4  4  4  4  4  4  4  4  4  4  4  4  4 -3 -3  4  4  4 -1  4 -1
-2  0  0  0  2 -7  6  6  2  2  2  2 -1  2  2  2  2  2  2 -7  2 -7  2  2  2  2  2  2  2  0  0  0  0  0  0  0  2  2  2  2  2  2  2  2  2  2  2  2  2  2  1  1  1  1  1  1  1  1  1  1  1  1  1  1  1  1  1  1  1  1  1  1 -1  4 -1  4 -1  4  4  4  4 -1 -1 -1  4 -1  4 -1  4  4  4 -1  4 -1  4  4 -1 -1  4  4  4  4  4  4 -1 -1 -1 -1 -1  4  4  4  4  4  4 -3 -3  4  4  4  4 -1
 0  0  0  2  2  2  2  2  2  2  2  2 -1  2  2  2  2  2  2 -7  2 -7  2  2  2  2  2 -7  0  0  0  0  0  0  0  0  2  2  2  2  2  2  2  2  2  2  2  2  2  2  2  1  1  1  1  1  1  1  1  1  1  1  1  1  1  1  1  1  1  1  1  1 -1  4 -1  4 -1  4  4  4  4 -1 -1 -1  4 -1  4  4  4  4  4  4  4 -1  4  4 -1 -1  4  4 -3  4  4  4  4  4  4  4  4  4  4 -1  4  4  4  4 -3 -3  4  4  4 -1
 0  0  0  2  2  2  2  2  2  2  2  2 -1 -1  2  2  2  2 -7 -7  2 -7 -7  2  2  2  2  2  0  0  0  0  0  0  0  2  2  2  2  2  2  2  2  2  2  2  2  2  2  2  2  2  1  1  1  1  1  0  0  0  0  0  0  0  1  1  1 -6  1  1  1  1 -1  4 -1  4 -1 -1 -1  4 -1 -1 -1 -1 -1 -1 -1 -1 -1 -1 -1 -1  4 -1 -1 -1 -1 -1  4  4  4  4  4  4  4  4 -1 -1 -1  4  4  4  4  4  4  4  4 -3 -3 -3 -3 -1
 0  0  2  2  2  2  2 -7 -7  2  2  2  2 -7 -7 -7 -7 -7 -7 -7  2 -7 -7 -7 -7 -7  2  2  0  0  0  0  0  0  0 -7  2  2  2  2  2  2  2  2  2  2  2  2  2  2  2  2  2  1  1  0  0  0  0  0  0  0  0  0  0  0  1  1  1  1  1  1 -1  4 -1  4 -1  4 -1  4  4  4  4  4  4  4  4  4  4  4  4 -1  4  4 -1 -1 -1 -1  4  4  4  4 -1  4  4  4  4  4  4  4  4  4  4  4  4  4 -3 -3 -3 -3 -3 -1
 0  0  2  2  2  2  2  2  2  2  2  2  2  2  2  2  2  2  2  2  2  2  2  2  2  2  2  0  0  0  0  0  0 -7  2  2  2  2  2  2  2  2  2  2  2  2  2  2  2  2  2  2  2  2  0  0  0  0  0  0  0  0  0  0  0  0  0  1  1 -6  1  1 -1  4 -1  4 -1  4 -1 -1 -1 -1 -1 -1 -1 -1  4 -1 -1 -1 -1 -1 -1  4  4  4 -1 -1  4  4  4  4  4  4  4  4  4  4  4  4  4  4  4  4  4 -3 -3 -3 -3 -3 -3 -1
 0  0  2  2  2  2  2  2  2  2  2  2  2  2  2  2  2  2  2  2  2  2  2  2  0  0  0  0  0  0  0  0  0  2  2  2  2  2  2  2  2  2  2 -1 -1 -1  2  2  2  2  2  2  2  0  0  0  0  0  0  0  0  0  0  0  0  0  0  0  1  1  1  1 -1  4 -1  4 -1  4 -1  4  4  4  4  4  4 -1  4 -1  4  4  4  4  4  4 -1  4 -1 -1  4  4  4  4  4  4 -1 -3  4  4  4 -1 -1  4  4  4 -3 -3 -3 -3 -3 -3 -3 -1
 0  2  2  2  2  2  2  2  2  2  2  2  2  2  2  2  2  2  2  2  2  2 -7  2  0  0  0  0  0  0  0  0  2 -7  2  2  2  2  2  2  2  2  2  2  2 -1  2  2  2  2  2  2  0  0  0  0  0  0 -2 -2 -2 -2 -2  0  0  0  0  0  0  1 -6  1 -1  4 -1  4  4  4 -1  4 -1  4  4  4  4 -1  4 -1 -1 -1 -1 -1 -1  4 -1 -1 -1 -1  4  4  4  4  4  4 -3 -1  4  4 -1 -3 -3 -1  4  4 -3 -3 -1 -1 -1 -3 -3 -1
 0  2  2 -7  2  2  2  2  2 -7  2  2  2  2  2  2  2 -7  2  2  2  2  2  0  0  0  0  0  0  0  0  0  2 -7  2  2  2  2  2 -1 -1 -1 -1 -1 -1 -1  2  2  2  2  2  2  0  0  0  0  0 -2 -2 -2 -2 -2 -2 -2  0  0  0  0  0  1  1  1  4  4 -1  4 -1 -1 -1 -1 -1  4  4  4  4 -1  4  4  4  4  4  4  4  4  4  4 -1 -1 -3 -3  4 -1  4  4  4  4  4 -1 -3 -3 -3 -1  4  4 -3 -3 -1 -3 -1 -3 -3 -1
-7  2  2  2  2  2  2  2  2  2  2  2  2  2  2  2  2  2  2  2  2  2  2  0  0  0  0  0  0  0  0 -7  2  2  2  2  2  2  2  2  2  2  2  2  2 -1  2  2  2  2  2  0  0  0  0  0 -2 -2 -2 -2 -2 -2 -2 -2 -2  0  0  0  0  0  1 -6 -1  4 -1  4  4  4  4  4  4  4  4  4  4 -1 -1 -1  4 -1  4  4  4  4  4  4 -1 -1 -3 -3 -3 -3  4  4  4  4  4  4 -1 -1 -1  4  4  4 -3 -3 -1 -1 -1 -3 -3 -1
-7  2  2  2  2  2  2  2  2  2  2  2  2  2  2  2  2  2  2  2  2  2  2  2  0  0  0  2  2  0  0  2  2  2  2  2  2  2  2  2  2  2  2  2  2 -1 -1 -1  2  2  2  0  0  0  0 -2 -2 -2 -2 -2 -2 -2 -2 -2 -2 -2  0  0  0  0  1  1 -1  4 -1 -1 -1 -1 -1 -1  4  4  4  4  4 -1  4  4  4  4 -1  4  4  4  4  4 -1 -1 -3 -3 -3 -3 -3 -3  4  4  4  4  4  4  4  4  4 -3 -3 -3 -3 -3 -3 -3 -3 -1
-7  2  2  2  2  2  2  2  2  2  2  2  2  2  2  2  2  2  2  2  2  2  2  2 -7  2  2 -7  2  2 -7  2  2  2  2  2  2  2  2  2  2  2  2  2  2  2  2  2  2  2  2  0  0  0  0 -2 -2 -2 -2 -2 -2 -2 -2 -2 -2 -2  0  0  0  0  1  1 -1  4  4  4  4  4  4  4  4  4  4  4  4 -1  4  4  4  4  4 -1  4  4  4  4 -1 -1 -3 -3 -3 -3 -3 -3  4  4  4  4  4  4  4  4  4 -3 -3 -3 -3 -3 -3 -3 -3 -1
-7 -7 -7 -7 -7 -7 -7 -7 -7 -7 -7 -7 -7 -7 -7 -7 -7 -7 -7 -7 -7 -7 -7 -7 -7 -7 -7 -7 -7 -7 -7 -7 -7 -7 -7 -7 -7 -7 -7 -7 -7 -7 -7 -7 -7 -7 -7 -7 -7 -7 -7  0  0  0  0 -2 -2 -2 -2 -2 -2 -2 -2 -2 -2 -2  0  0  0  0 -1 -1 -1 -1 -1 -1 -1 -1 -1 -1 -1 -1 -1 -1 -1 -1 -1 -1 -1 -1 -1 -1 -1 -1 -1 -1 -1 -1 -1 -1 -1 -1 -1 -1 -1 -1 -1 -1 -1 -1 -1 -1 -1 -1 -1 -1 -1 -1 -1 -1 -1 -1